xxxgxxxxxxxxx
x-----------x
x-----------x
x--p--------x
x-----------x
x-----------x
x-----------x
x-----------x
x-----------x
x-----------x
x-----------x
x--m--------x
xxxxxxxxxxxxx