xxxxxxxgxxxxx
x-----------x
x-xxx---x-x-x
x-------x-x-x
xxxxx---x-x-x
x---x-------x
x-xxx-xxx---x
x-------xm--x
x-------xxx-x
x-------x---x
x-xxx---xxx-x
x-x--------px
xxxxxxxxxxxxx