xxxxxxxxxxxxx
x------p----x
x-x-----xxx-x
x-x---------x
x-xxxxxxx---x
x-x---x-----x
x-x---xxx-xxx
x-x---------x
x-x-xxx-----x
x------m----x
x---xxxxx---x
x-----------x
xxxxxxxgxxxxx