xxxxxxxxxxxxx
x-x---xp----x
x-x-x-xxx---x
g---x-------x
x---xxxxxxx-x
x-----x---x-x
x-----x---x-x
x----m------x
x-xxxxxxx---x
x---x---x---x
x-xxx-xxx-xxx
x-x---------x
xxxxxxxxxxxxx