xxxxxxxxxxxxx
x-----------x
x-----------x
g-----------x
x-xxx-xxx---x
x---x---x---x
x---xxxxx---x
x-----x-xp--x
x-xxx-x-xxx-x
x--mx---x---x
x-xxxxxxx---x
x-----------x
xxxxxxxxxxxxx