xxxxxxxxxxxxx
x--mx-------x
x-xxxxxxx-xxx
x----------px
x-x-----xxx-x
x-x-----x---x
xxx-xxx-x-xxx
g-----------x
x---xxx-----x
x---x-------x
x-xxx-------x
x-x---------x
xxxxxxxxxxxxx