xxxxxxxxxxxxx
x-----------x
x-xxx-x-----x
x---x-x-----x
xxx-x-x-xxx-x
x---x------px
x---x-x---x-x
x---x-x---x-x
x-xxxxx---xxx
x-----x---xmx
xxx---x---x-x
x-----------x
xxxxxxxxxgxxx