xxxgxxxxxxxxx
x-----------x
x-----xxx---x
x--m--------x
x-xxx-x-xxx-x
x-----x---x-x
x-----xxxxx-x
x-----x--p--x
x-x---xxx---x
x-x-----x---x
xxx-----x---x
x-----------x
xxxxxxxxxxxxx