xxxxxxxxxxxxx
x---x-------x
xxx-x-x---x-x
x--px-x---x-x
xxx-x-xxx-x-x
x---x---x-x-x
x---x-xxx-x-x
x-----x---x-x
x---xxxxx-x-x
x-----x-----x
xxxxx-x-xxx-x
x--m--------x
xxxgxxxxxxxxx