xxxxxxxxxxxxx
x-----------x
x-----xxx---x
x--p--------x
x-xxxxxxx-xxx
x-x-x-----xmx
x-x-x-xxx-x-x
x-----------x
xxx---xxx-xxx
x-------x---x
x---xxxxxxx-x
x-----------x
xxxxxxxxxxxgx